Acct	tests/integration/samples/Acct.fa	tests/integration/samples/Acct.fa.treefile
Al12e	tests/integration/samples/Al12e.fa	tests/integration/samples/Al12e.fa.treefile
Amcm	tests/integration/samples/Amcm.fa	tests/integration/samples/Amcm.fa.treefile
Ansf2	tests/integration/samples/Ansf2.fa	tests/integration/samples/Ansf2.fa.treefile
Apsma	tests/integration/samples/Apsma.fa	tests/integration/samples/Apsma.fa.treefile
Arad51	tests/integration/samples/Arad51.fa	tests/integration/samples/Arad51.fa.treefile
Arla2	tests/integration/samples/Arla2.fa	tests/integration/samples/Arla2.fa.treefile
Arpl24	tests/integration/samples/Arpl24.fa	tests/integration/samples/Arpl24.fa.treefile
Arpl7	tests/integration/samples/Arpl7.fa	tests/integration/samples/Arpl7.fa.treefile
Arpo	tests/integration/samples/Arpo.fa	tests/integration/samples/Arpo.fa.treefile
Bcct	tests/integration/samples/Bcct.fa	tests/integration/samples/Bcct.fa.treefile
Bl12e	tests/integration/samples/Bl12e.fa	tests/integration/samples/Bl12e.fa.treefile
Bmcm	tests/integration/samples/Bmcm.fa	tests/integration/samples/Bmcm.fa.treefile
Bnsf2	tests/integration/samples/Bnsf2.fa	tests/integration/samples/Bnsf2.fa.treefile
Bpace2	tests/integration/samples/Bpace2.fa	tests/integration/samples/Bpace2.fa.treefile
Bpsma	tests/integration/samples/Bpsma.fa	tests/integration/samples/Bpsma.fa.treefile
Brla2	tests/integration/samples/Brla2.fa	tests/integration/samples/Brla2.fa.treefile
Brpl24	tests/integration/samples/Brpl24.fa	tests/integration/samples/Brpl24.fa.treefile
Brpo	tests/integration/samples/Brpo.fa	tests/integration/samples/Brpo.fa.treefile
Brrp46	tests/integration/samples/Brrp46.fa	tests/integration/samples/Brrp46.fa.treefile
